		#####
		#	#
		#$  #
	  ###  $##
	  #  $ $ #
	### # ## #	 ###### 
	#   # ## ####   ..#
	# $  $ 			..#
 	#### ### #@##   ..#
	   #     ##########
	   #######
